111111
1P0C11
1C0E11
1100K1
111111