111111
1P0001
10C101
101001
1E1111