111111
1PC001
111111
1E0001
111111